NO  ./textures/for_test_text.xpm

SO  ./textures/wall_hmaarxpm.xpm
WE  ./textures/wall_hmaarxpm.xpm
EA  ./textures/sand.xpm

F 193, 154, 107
C 135, 206, 235

1111111111111111111111111
1000000000110000000000001
10110N001110000000000001111 
100100000000000000000000111
11111100101100000111000011111
100000000011000001110111111
10000110001001011101010101
11110110011101001100000011111
11110111111000011101010010001
11000000110000011100000010001
100000000000000001100000010001
10000000000100001101010010001
110000011101010111110111100111
11111111 1110101 10111101001
11111111 1111111 111111111111
