NO ./textures/wall_hmaarxpm.xpm
SO ./textures/wall_hmaarxpm.xpm
WE ./textures/wall_hmaarxpm.xpm
EA ./textures/wall_hmaarxpm.xpm

F 193, 154, 107
C 135, 206, 235


1111111111111111111111111
1000000000110000000000001
10110000011100000N0000001
1001000000000000000000001
1111110010110000011100001
1000000000110000011101111111111111111
10000110001001011101010101
11110110011101001100000011111
11110111111000011101010010001
11000000110000011100000010001
100000000000000001100000010001
10000000000100001101010010001
110000011101010111110111100111
11111111 1110101 10111101001
11111111 1111111 111111111111
