C 60,10,10
F 30,30,30

NO ./textures/message.txt
SO ./textures/mossy.xpm
WE ./textures/bluestone.xpm
EA ./textures/greystone.xpm

11111111111111111111111111111111111111111
10000000000000000000000000000000000000001
10000000000000000000000000000000000000001
10000000000000000000000000000000000000001
10000000000000000000000000000000000000001
10000000000000000100000000000000000000001
10000000000000000W10000000000000000000001
10000000000000000000000000000000000000001
10000000000000000000000000000000000000001
10000000000000000000000000000000000000001
10000000000000000000000000000000000000001
10000000000000000000000000000000000000001
10000000000000000000000000000000000000001
11111111111111111111111111111111111111111
