NO  ./textures/wall_hmaarxpm.xpm
SO  ./textures/wall_hmaarxpm.xpm
WE  ./textures/wall_hmaarxpm.xpm
EA ./textures/wall_hmaarxpm.xpm


F 193, 154, 107
C 135, 206, 235


111111111111111111111111111111111111111111111
100000000000000000000000000000000000000000001
100000000000000000000000000000000000000000001
1000000000000000000000N0100000000000000000001
100000000000000000000001000000000000000000001
100000000000000000000000000000000000000000001
111111111111111111111111111111111111111111111111
